111111111111111
101010000101001
100001011000101
110100001010101
101101100010101
100000001010101
101111101111101
100100000000001
110111111111111
100010000010101
111010101010001
100010101010101
101111101010101
100000001000101
111111111111111