111111111111111
1010100C01010E1
100001011000101
110100001010101
101101100010101
100C00001010101
101111101111101
10010000C000001
110111111111111
100010000010101
111010101010001
100010101010101
101111101010101
1000000010P0101
111111111111111